###########
#.........#
#.@.......#
#.........#
#.........#
#.........#
###########