###############
#.#.#.#.#.#.#.#
#.....@.......#
#.#.#.#.#.#.#.#
#.............#
#.#.#.#.#.#.#.#
#.............#
###############